R 800 600
NO ./textures/toood.xpm
SO ./textures/SO.xpm
WE ./textures/CEO.xpm
EA ./textures/EA.xpm
S ./textures/ITEM.xpm
F 0,128,0
C 80,188,223

        1111111111111111111111111
        1000000000000000000000011
        1100000000000000000000001
        1000000000000000000000001
111111111000000000000000000000001
100000000000000000000000000001111
10000000000000000000000000001
10000000000000S00000000000001
10000000000000000000000000001
10000000000000000000000000001
10000000000000222001010000001
11000001010111011111011110101
111101110111 101 101111010001
111111111111 111 111111111111